  {
	"audio":"res://audio/songs/level3.mp3",
	"beats_per_die":1.0,
	"bpm":120.0,
	"dice":[
		6,6,6,6,5,5,5,6,4,4,
		4,6,2,2,2,6,3,3,3,6,
		5,5,5,1,5,5,6,6,4,4,
		4,1,4,4,6,6,2,2,2,1,
		2,2,6,6,3,3,3,1,3,3,
		6,6,5,5,5,1,1,1,1,1,
		4,4,4,1,1,1,1,1,2,2,
		2,1,1,1,1,1,3,3,3,1,
		5,5,6,6,5,1,5,1,1,1,
		1,5,4,1,4,1,1,1,1,4,
		2,1,2,1,1,1,1,2,3,1,
		3,1,1,1,1,3,5,1,5,1,
		1,1,1,5,4,1,4,1,1,1,
		1,4,2,1,2,1,1,1,1,2,
		3,1,3,1,1,1,1,3,6,6,
		6,6,6,6,6,6,6,6,6,6,
		6,6,6,6,6,6,6,6,6,6,
		6,6,6,6,6,6,6,6,6,6,
		3,3,3,6,2,2,2,6,4,4,
		4,6,5,5,5,6,3,3,3,1,
		3,3,6,6,2,2,2,1,2,2,
		6,6,3,3,3,1,1,1,1,1,
		2,2,2,1,1,1,1,1,4,4,
		4,1,1,1,1,1,5,5,5,1,
		5,5,6,6,3,1,3,1,1,1,
		1,3,2,1,2,1,1,1,1,2,
		4,1,4,1,1,1,1,4,5,1,
		5,1,1,1,1,5,3,1,3,1,
		1,1,1,3,2,1,2,1,1,1,
		1,2,4,1,4,1,1,1,1,4,
		5,1,5,1,1,1,1,5,5,1,
		5,1,1,1,1,5,6,6,6,6
		],
		"level_name":"level3"
	}
