{"audio":"res://audio/level3.mp3","beats_per_die":1.0,"bpm":120.0,"dice":
	[
		6,6,6,6,
		
		2,2,2,2,5,5,5,6,
		5,5,5,5,2,2,2,6,
		2,2,2,2,5,5,5,6,
		5,5,5,5,2,2,2,6,
		
		6,2,6,2,6,2,6,2,
		6,2,6,2,6,2,6,2,
		
		6,6,6,6,1,1,1,1,
		6,6,6,6,1,1,1,1,
		6,6,6,6,1,1,1,1,
		
		6,6,6,6,6,6,2,2,
		
		
		2,1,2,2,2,2,2,2,
		2,1,2,2,2,2,2,2,
		2,1,2,2,2,2,2,2,
		2,1,2,2,2,2,2,2,
		
		5,1,5,5,5,5,5,5,
		5,1,5,5,5,5,5,5,
		2,1,2,2,2,2,2,2,
		2,1,2,2,2,2,2,2,
		
		6,6,6,6,6,6,6,6,
		6,6,6,6,6,6,6,6,
		6,6,6,6,6,6,6,6,
		6,6,6,6,6,6,6,6,
		
		2,2,2,2,5,5,5,6,
		5,5,5,5,2,2,2,6,
		2,2,2,2,5,5,5,6,
		5,5,5,5,2,2,2,6,
		
		6,6,6,6,1,1,1,1,
		6,6,6,6,1,1,1,1,
		6,6,6,6,1,1,1,1,
		6,6,6,6,6,6,2,2,
		
		
		2,1,2,2,2,2,2,2,
		2,1,2,2,2,2,2,2,
		2,1,2,2,2,2,2,2,
		2,1,2,2,2,2,2,2,
		
		5,1,5,5,5,5,5,5,
		5,1,5,5,5,5,5,5,
		2,1,2,2,2,2,2,2,
		2,1,2,2,2,2,2,2,
		
		2,1,2,2,2,2,2,2
		],"level_name":"level2"}
