  {
	"audio":"res://audio/level1.mp3",
	"beats_per_die":1.0,
	"bpm":90.0,
	"dice":[
		6,6,6,6,6,6,6,6,
		6,6,6,6,6,6,6,6,
		6,2,2,2,2,2,2,2,
		2,2,2,2,2,2,2,2,
		
		6,5,5,5,5,5,5,5,
		5,5,5,5,5,5,5,5,
		
		6,3,4,3,4,3,4,3,
		4,3,4,3,4,3,4,3,
		6,3,4,3,4,3,4,3,
		4,3,4,3,4,3,4,3,
		
		6,6,6,6,6,6,6,6,
		6,6,6,6,6,6,6,6,
		6,6,6,6,6,6,6,6,
		6,6,6,6,6,6,6,6,
		
		3,3,3,1,3,3,3,1,
		3,3,3,1,3,3,3,1,
		4,4,4,1,4,4,4,1,
		4,4,4,1,4,4,4,1,
		5,5,5,1,5,5,5,1,
		5,5,5,1,5,5,5,1,
		2,2,2,1,2,2,2,1,
		2,2,2,1,2,2,2,1
		],
		"level_name":"level1"
	}
