{
	"bpm": 120,
	"audio": "res://audio/basic_song.wav",
	"dice": [
		1, 1, 1, 1, 5, 5, 5, 5, 
		5, 5, 5, 5, 5, 5, 5, 5,
		5, 2, 5, 2, 5, 2, 5, 2,
		5, 2, 5, 2, 5, 2, 5, 2,
		6, 2, 6, 2, 6, 2, 6, 2,
		6, 2, 6, 2, 6, 2, 6, 2,
		6, 2, 6, 2, 6, 2, 6, 2,
		6, 2, 6, 2, 6, 2, 6, 2,
	]
}
